1111111111111
1000C000000C1
1111011111001
1PCC10E000001
1111111111111