1111111111111
1000C000E00C1
1111001111111
1PCC000000001
1111111111111