1111111111111
1C00000011111
111E111110101
1PC0000000011
1111111111111