1111111111111
1C00001C0E111
1011111110101
1PC0000000011
1111111111111