1111111111111
10C010P011111
11001C001E1C1
1000110000001
1111111111111