1111111111111
1000C000000C1
1111E11111001

1PCC000000001
1111111111111