1111111111111111111111111111111111
1E1000000000000C00000C000000000001
10100101C0100000101001000000010101
1010010010101010001001000000010101
1P0000000C00C0000000000000000000C1
1000000000000000000000000000000001
100000000000000C00000C000000000001
1010010100100000101001000000010101
1010010100100000101001000000010101
1010010100100C00101001000000010101
1010010100100000101001000000010101
101001010010000010100100000C010101
1010010100100000101001000000010101
1010010100100000101001000000010101
101001010010000010100100C000010101
1010010100100000101001000000010101
10100101001000001010010000000101C1
1C100101001000001010010000000101C1
1111111111111111111111111111111111