11111111111111111111111111111111111111111111111111
11111100100100001111111100111110010000001000111111
11111100100000000000000000111110000001000000111111
11111100000001000000000000000000000001000000111111
10000001000100010000000100000000001100000000000001
10000000000100000010000000001000000000010000000001
10000000000000000000000010000000000010000000000001
11000010001000000000000000100111000010001000000001
11000000100010000000000000100000000010000001111111
10010000100000000110011000000000000010000000000001
100100C0100000000110000000010000010000000000000001
10000000001001000000000000000000000100000000010001
11100C00001000000000100111001001000000000100010011
10001000100000011100000000000001001001000000000011
10000000000000000000000000000001000000010000100001
11100000001000000000000000000000000000000000001001
11100011000010000001000000001000100000001000000011
10000011000000100100000010000000100011001000000001
10000011001100100100000010000000000000000000001001
11000011001100000C00000000000000011100000010001001
10000000000000001000000100100000011100001000100001
10000C00000000100000000000000010011100001000000011
10011000000000100000000010000010000000000000000001
10011000000000000100000000010000000011000000000101
10011000111100000000000001000001100000011100010001
11000000111100001000000000000100001000011100000011
10000000000000100000001110000100000001000000100001
10010010000000100010001110000001100000000010000001
11000000000000100010001110010001100100000010010001
11000001110000001000000000000000000100000010010001
10000100000000000000000000000100000000000010000001
10000000000001000100000010000100001000000000000111
10000000000100010000000000010000P01000000000100111
100011100000000000010000000000010000100110001000E1
11100000000000000000000001100000010000000010000011
11100000100000100000011000000110000000000000000011
11100000000110000111000000000110000000000001110011
11100000000000000111000010000110011100010000000001
1110000110000000011100001001000000000C010000000001
11100100000000000000000000000000000001000100010011
11100100011000110000100100000000000000000000000011
11100000000000000000100100000011100000000000000001
10000001000010001110000000100000001000100011100001
10000001000000000000000000000000001000100000000011
10000000000100000000001000000000001000000000000011
1000000001000000110000C000100000000000001000000011
11001110000000000000000110000001000000000011000011
11000000001111000000000000000000011100010011000001
10010000001111000010010001001100011100000011001101
11111111111111111111111111111111111111111111111111